Llevarte al Cielo - Natalia Jiménez 
Sandunga - Don Omar, Wisin y Yandel
Mujeres Divinas - Vicente Fernández
Que Agonía - Yuridia, Ángela Aguilar
Contigo en la distancia - Luis Miguel 
De Vacaciones - FMK
Castigo - Los Rivera Destino, Pedro Capo
Tas Bella - Reggi el auténtico ✅
Baila Kumi - Ir Sais, Manuel Turizo
Agua de Jamaica - Maluma 
Aurora Remix - Jhosy, Beele, Manuel Turizo
Noche Loca - Donkirap, Zion & Lennox
10 PM - Blessd 
Tonika - Maluma, Ziggy Marley
Mi Cuarto - Jerry Di
No se que - Boza ✅
Que  Vamo’ Hacer - Lenny Tavarez, Anitta
Las Locuras Mías - Omar Chaparro, Joey Montana 
El Mariachi Loco - Pedro Fernández 
Cachito de Cielo - Pedro Fernández 
Más que tu amigo - Marco Antonio Solís 
Canto a Colombia - Juan Luis Guerra
Como lo hice yo - Matisse, Carin Leon
Esa Parte de Mi - Los Angeles Azules, Sofia Reyes
Ce Topa - Luan Santana (Está en portugués)
No se va - Grupo Frontera 
Not steady - Paloma Mami ✅
Marea - Tommy Torres
Eres - Cafe Tacvba 
L-Gante RKT Sessions #1 - L-Gante
Ni un centavo - Malacates Trébol Shop
Bésame Mucho - Pedro Infante
Amorcito Corazón - Pedro Infante 
Nada fue un error - Coti, Paulina Rubio, Julieta Venegas
Es por ti - Juanes
El Último Trago - Viento en Contra 
Mis Planes son amarte - Juanes
Ángel - Juanes
Alguien Mejor - Carin Leon
El Malo - Carin Leon
Me la Aventé - Carin Leon
Amor Tumbado - Natanael Cano, Alejandro Fernández 
Tu me gustas - Rio Roma, Carin Leon
Mi debilidad - Jessi Uribe
Gucci los paños - Karol G
La Reina - Maluma
Los discípulos - Eddie Dee, Daddy Yankee
La Parranda - Jon z
La Boda - Maffio, La Perversa, Yomel el meloso 
No lo compro - Urba Y Rome, Brray Juanka
Contra la pared - Sean Paul, J Balvin 
Amarillo - J Balvin 
Segurosqui - Daddy Yankee
No quiero Amores - Yandel, Ozuna
23 - Randy
Ultimate - Steve Aoki, Santa Fe Klan, Snow the Product
En la cama - Nicky Jam, Daddy Yankee
Solo - Amenazzy, Lary Over
Adicto a tus redes - Tito el bambino, Nicky Jam
La invitación - Pipe Bueno, Maluma
Bebe - Camilo, El Alfa
De Cora <3 - Rauw Alejandro, J Balvin
Una Cita Remix - Alkilados, J Álvarez, Nicky Jam
Hasta que Dios diga - Anuel AA, Bad Bunny
Haciéndolo - Ozuna, Nicky Jam
Pretextos - Maluma, Cosculluela 
Sunset - Farruko, Shaggy
Fuiste tu - Ricardo Arjona, Gaby Moreno
Salgamos - Kevin Roldán, Andy Rivera, Maluma
No quiere enamorarse - Ozuna 
Tranquila - J Balvin
Wow wow - Maria Becerra, Becky G
Aventura - Lunay, Anuel Aa Ozuna
Te pintaron pajaritos - Yandar & Yostin, Andy Rivera (Primera canción de reggaeton que escuche y me gusto)
Mi debilidad - María Becerra
Acércate - De La Ghetto
El tiempo se va - Henry Méndez 
Me matas - Kevin Roldán, Arcangel 
Dancing Kizomba (Spanish Version) - Alx Veliz 
Santa de mi devoción - Alexis y Fido
Báilame Despacio - Xantos, Dynell
Corazón Acelerao - Wisin
Bonita (Down 4 Me Remix) - Jhoni the Voice, Kevin Roldán
Hello - Karol G, Ozuna
Bajito - Jencarlos, Ky-Mani Marley
Gucci Fendi - Justin Quiles, Eladio Carrión 
Satisfacción - Arcangel, Myke Towers
No vuelvas más - Darell
Los Malvekes - Cris Mj, Marcianeke
El Cigarro - Micro TDH
Me arrepentí - AK4:20, Cris Mj, Pailita 
Te doblaste - Kiko el Crazy, Arcangel
Comandante - Kiko el Crazy, Randy, Braulio Fogon
Las Dudas - Sebastián Yatra, Aitana
Formentera - Aitana, Nicki Nicole
ID - KEVVO, Zion & Lennox 
La Funka - Ozuna
Linda - Tokischa, Rosalia 
Diosa - Zion & Lennox, Rauw Alejandro
La Old Skul - Rauw Alejandro
TBC - Lunay
Ella - Boza
Municiones - Anuel AA, Ozuna
Anaranjado - Jowell & Randy, J Balvin
Buena Vibra - Ale Mendoza (Esta canción es de artistas Guatemaltecos, la verdad no es la mejor pero se  va jaja)
Calma Remix - Pedro Capo, Farruko
Sígueme los pasos - Ozuna, J Balvin
Ibiza - Ozuna, Romeo Santos
Hooka & Sheridan - Tommy Boysen
Tírate un Paso Remix - Tayl G, Lary Over
Beso A Beso - Toño Rosario 
Un idiota - Eddy Herrera
Mi Bom Bom - El Alfa, Nesi
Se Acabo la Cuarentena - Jowell & Randy, Kiko El Crazy

Te quiero mucho